20,20
1,1,19,18
8
5,9,8,10,9,7
8,17,13,12,8,12
11,1,11,6,14,6,14,1
10,10,12,12,15,10,12,8
5,14,5,16,7,16,7,14
13,15,15,16,17,14,15,13,14,14
6,3,6,7,9,7,9,3
16,5,16,10,18,10,18,5