20,20
1,1,19,18
7
2,9,6,9,0,5
8,17,13,12,8,12
11,1,11,6,14,6,14,1
10,9,12,11,15,9,12,7
1,14,3,16,8,16,8,14
13,15,15,16,17,14,15,13,14,14
6,3,6,7,9,7,9,3