20,20
2,2,11,16,5,4,18,6,7,9
4
10,10,12,11,14,10,13,12,11,12
12,3,14,4,15,6,13,7,11,5
4,10,6,11,8,10,7,12,5,12
10,13,8,15,14,15,14,13
